0,0,0,0,0,0,0,0,0,0,0,0,902,0,0,0,0,0,0,0
0,0,0,0,0,0,0,0,0,0,0,0,900,0,0,0,0,0,0,0
0,0,0,0,0,0,0,0,0,0,0,0,900,0,0,0,0,0,0,0
0,0,0,0,0,0,0,0,0,0,900,900,900,0,0,0,0,0,0,0
0,0,0,0,0,0,0,0,0,0,900,0,0,0,0,0,0,0,0,0
0,0,0,0,0,0,0,0,0,0,900,0,0,0,0,0,0,0,0,0
0,0,0,900,900,900,900,0,0,0,900,900,900,900,0,0,0,0,0,0
0,0,0,900,0,0,900,0,0,0,0,0,0,900,0,0,0,0,0,0
0,0,0,900,0,0,900,0,0,0,0,0,0,900,0,0,0,0,0,0
0,0,0,900,0,0,900,0,0,0,0,0,0,900,0,0,0,0,0,0
901,900,0,900,0,900,900,0,0,0,0,0,0,900,0,0,0,0,0,0
0,900,0,900,0,900,0,0,0,0,0,0,0,900,0,0,0,0,0,0
0,900,0,900,0,900,0,0,0,0,0,0,0,900,0,0,0,0,0,0
0,900,0,900,0,900,900,900,900,900,900,900,900,900,0,0,0,0,0,0
0,900,0,900,0,0,0,0,0,0,0,0,0,0,0,0,0,0,0,0
0,900,0,900,0,0,0,0,0,0,0,0,0,0,0,0,0,0,0,0
0,900,900,900,0,0,0,0,0,0,0,0,0,0,0,0,0,0,0,0
0,0,0,0,0,0,0,0,0,0,0,0,0,0,0,0,0,0,0,0
0,0,0,0,0,0,0,0,0,0,0,0,0,0,0,0,0,0,0,0
0,0,0,0,0,0,0,0,0,0,0,0,0,0,0,0,0,0,0,0
